****************************************
*.................,....................*
*......................................*
*......................................*
*......................................*
*..................*...................*
*..................*...................*
*..................*...................*
*..................*...................*
*......................................*
*......................................*
*...........****.......****............*
*......................................*
*......................................*
*..................*...................*
*..................*...................*
*..................*...................*
*..................*...................*
*......................................*
*......................................*
*......................................*
*..P.........T.........................*
****************************************