******************************
*........*........*..........*
*.*.....*..*.*.*....*..*.....*
*....*..*...*...*...........* 
*.*.*.*.*..*......*..........*
*......*....*....*.*........*
*...........*....*..*.......*
*..*..*..*....*...*....*....*
*.*...........*.....*.....*..*
*...........*.*.....*....*...*
******************************
