******************************
*....*........*..............*
*.*...*.*.*....*..............*
*...........*..*..*.*.....*...*
*.*......*....*....*.*.......*
*..*.......*....*..*....*....*
*..*.*.*....*..............*..*
*...*..........*..*....*.....*
*.......*...*...*..*.........*
*..........*.*..*.*..*...*...*
******************************
