******************************
*.U......*........*...........*
*.*.*.*.*.*.*.*.*.*.*.*.*.*.....*
*....*...........*...........*
*.*.*.*.*.*..*........*........*
*..*...........*....*..*.....*
*.....*.*.*...*...............*
*...*...........*..*..*......*
*........*.*..*....*....*....*
*..*....*....*..........*....*
******************************
